0,7,7,1,2,7,8
7,7,7,1,2,7
7,7,7,1,2,7
3,3,3,4,2,7
6,6,6,6,5,7
7,7,7,7,7,7
